.................#..................#.................................
.................#..................#.................................
.................#....................................................
.................#.................................###################
......................................................................
......................................................................
#################..................................###################
....................................#.................................
....................................#.................................
....................................#.................................
....................................#########....#####................
......................................................................
################......................................................
...............#..............#...........#............#..............
...............#..............#...........#............#..............
...............#..............#...........#............#..............
...............#..............#...........#............############...
...............#..............#...........#...........................
...............#..............#...........#...........................
...............#..............#...........#...........................