.................#..................#.................................
.................#..................#.................................
.................#....................................................
.................#.................................###################
......................................................................
......................................................................
#################..................................###################
....................................#.................................
....................................#.................................
....................................#.................................
....................................#########....#####................
......................................................................
################......................................................
...............#..........................#...........................
...............#..........................#...........................
...............#..........................#...........................
...............#..........................#............############...
...............#..........................#...........................
...............#..........................#...........................
...............#..........................#...........................